R  2000 1200

SO ./textures/bookshelf.xpm
WE ./textures/bricks.xpm
EA ./textures/ice.xpm
S  ./textures/sprites/enemy.xpm
NO  ./textures/leavesop.xpm

C	26,  51, 55

F	20,49, 77

1111                                
100111111111111111111111111     11111
100111111111100002000000011     10001
1000000000000000000000000011111100001
12000000002222200000000N0000000000001
1000000020000000121000000001000000001
1000011111111000111000000111111111111
100001      100000000000001         
100001      100002000000001
111111      111111111111111
