R 1024 768

NO ./textures/greystone.xpm
SO ./textures/mossy.xpm
WE ./textures/wall_grey.xpm
EA ./textures/redbrick.xpm
S  ./textures/sprites/pillar2.xpm

C 26,  51, 55
F 20, 49, 76

        1111111111111111111111111
        1000000000110000000000001
        1011000001110000000000001
        10010000000000200200W0001
111111111011002001110000000000001
100000000011000001110111110111111
11110111111111011100000010001
11110111111111011101010010001
11000000110101011100200010001
10000002000000000000000000001
10000000000000001101010010001
11000001110101011111011110001
11110111 1110101 101111010001
11111111 1111111 111111111111
